000mmmmm0m00mmm
0m00000m0mm0m00
00mm0m000m0000m
m000mmmm000m0mm
000m00000mmm00m
mm0mmmm0m0000mm
000mmm0000mmmmm
0m000mm0m0mm00m
0mm0m000m000mmm
mmm00m0mm0mmmmm
mmm0mm0m00mm00m
m000m00m0mm00mm
00mm00m00000mmm
mmm000mm0mm0mmm
m0000mmm00m000a
